.....#..
.X..:#  
........
.#.##...
.#.##.##
.....  c
.....###
......BA
