B#... .c
A..    .
#.. ..##
c#......
 #.... .
 ### c .
.:.:   .
X... ...
