AB : c  
:######.
 #..#.  
c.:.#...
.#....:.
#.......
###   ..
X.c  ...
