######c#
c   .# #
###..# #
#c .....
###.A.B.
........
....:::.
.X .....
