...#c...
.:....#A
# #...#.
# #...#.
#c :..#B
#.      
#.:  :.c
##.X ...
