.# ....c
...A..B.
.#... ..
.#... ..
.###....
.c.#....
...   #.
X.. c +.
