... ####
...... c
.###c..#
 A.B #.#
.###  .#
.. .c .#
#X.....#
########
